XXXXXXXXXXXXXXXX
XS000000000000GX
X0000000000XX00X
X00XXX00000XX00X
X00XXX000000000X
X00XXX000000000X
X00XXX000XXX000X
XG0XXX000XXX000X
X00000000XXX000X
X00000000XXX00GX
X000000000XX000X
X0000X000000000X
X000XXX00000000X
X00XXXXX0000000X
XG000000000000GX
XXXXXXXXXXXXXXXX