XXXXXXXXXXXXXXXXXXXXXXXXXX
XS0000X00000000000000000GX
X00000X0000000000000XX000X
X00X000000000000000000000X
X00000X00000X0000XX000000X
X00000XXXXXXX000000000000X
XX0XXXX00000X000000000000X
X00000000000X000XXXXXXXXXX
X00000000000X000000X00000X
XXXX00000000X000X00000000X
X00X00000000000XX00X00000X
X00X00XXXXXXX00000000XX0GX
XG0000000000X000X00X00000X
X00000000000XXXXXX0XXXX0XX
X000000000000000000X00000X
X000X00000000000000X00000X
X000000000000000000X00000X
X0000000X0000000000X00000X
X0000000XXXXXXXXXXXX00000X
X0000000X000000000X000000X
X0000000X000000000X0XXXXXX
X0000000X0000000X00000000X
X000000000000000X00000000X
XG000000X0000000X0000000GX
XXXXXXXXXXXXXXXXXXXXXXXXXX